_,x,_,_,_,_,_,_,_,x,_,_,_,_,
_,x,_,_,_,_,_,_,_,x,_,_,_,_,
_,x,_,_,_,_,_,_,_,x,_,_,_,_,
_,x,_,_,_,_,_,_,_,x,_,_,_,_,
_,x,_,_,_,_,x,_,_,_,_,_,_,_,
_,x,_,_,_,_,x,_,_,_,_,_,_,_,
_,x,_,_,_,_,x,_,_,x,_,_,_,_,
_,x,_,_,_,_,x,_,_,x,_,_,_,_,
_,x,_,_,_,_,x,_,_,_,_,_,_,_,
_,x,_,_,_,_,x,_,_,_,_,_,_,_,